NO textures/blue_stone.xpm
SO textures/color_stone.xpm
WE textures/grey_stone.xpm
EA textures/red_brick.xpm
F 150,75,0
C 173,216,230
1111111111111111111111111
1000000000110000000000001
10110000011100000S0000001
100100000000000000000000111111111
111111C11011000001110000000000001
100000000011000001110111111111111
11110111111111011100000010001
11110111111111011101010010001
11000000110101011100000010001
10000000000000001100000010001
10000000000000001101010010001
110000011101010111110111100111
11110111 1110101 101111010001
11111111 1111111 111111111111
