NO textures/blue_stone.xpm
SO textures/color_stone.xpm
WE textures/grey_stone.xpm
EA textures/eagle.xpm
F 150,75,0
C 0,0,0
1111111111111111111111111
100N000000011111000000001
1011101110100010101111001
1000101000100010100000001
1010101010101010111111101
1000101000000010000000101
1110111011111010111110101
1000000010001010000010101
1011111010111010111010101
1000001010001000100010101
1011101010111010111010101
1000101000100010000010101
1010101010101010111010101
1111111111111111111111111

