NO textures/blue_stone.xpm
SO textures/color_stone.xpm
WE textures/grey_stone.xpm
EA textures/eagle.xpm
F 150,75,0
C 0,0,0
1111111111111111111111111111111111111111111111111111111
1000000000100011111111000000000000100000100000000000001
1000000000111001111111111011111110111011101111101011111
1110111010001000111000101010001000001110101000101000001
1010001011111010111011101010111110100010000011101110001
1010101000000010000000001000000010101011111010101000101
1000111111111010111110111111111010101000101010111111101
1000000010001010000010000010000010101111101010000000001
1011111010111010111110111111111011100000001011101110111
1010001010100010100010000000001010101110111010101000001
1010111110111111101110111010101010100010000000101111111
1010000000000000001000001010101000100010000000100000001
1011101111111111101111101010111110111010111111111010101
1000001010100000101000101010100000101010101000100010101
1111111010111011101001111110111110101110101110111110111
1001000010000000000001000000101010101000100010000000101
1001101111111011111111011110101010101111111011101111101
1E00000000001010000001010010001000000000000010101000001
1011101110101011101111011011111111111001111010101011101
1010000010111010100000010000000000001000101010000000101
1111111110000000101111010010111110001111101011111010111
1000100000000000101000011110101010000000001000101010101
1110111111111111101110000010101010111111011110101011101
1000001000101000001010011110101000100001000010101010001
1011101011101111101010010010101111110111011110101111101
1010101000000000000011110000000000000100001010100000001
1010101110101111111010011111111111110101101010101111101
1010000000100010001010000101000100000101001000001000101
1011111111111110111110011101110111110111101110111110101
1000010001000000000000000001010000010000001010101000001
1011111101000001110000010101010111010111001010101011101
1000000001000111111100010101010101000111100010100010101
1011111111011111111111110111010101011111001111111010101
1000000000011111111111000000000001011111100000000000101
1111111111111111111111111111111111111111111111111111111